....................
....................
....................
....................
....................
....................
...CC...............
...##......CCC......
...........###......
......CCC...........
......###.......CCC.
................###.
.###................
....................
####################
